1111111111111111111111111111111111111111111111111111111111111
1111111111111111000000000000100000000100000000000000000000001
1111111111111111000000000000100000000100000000000000000000001
1111111111111111000000000000100000000100000000000000000000001
1111111111111111000000000000100000000100000000000000000000001
1111111111111111000000000000100000000100000000000000000000001
1111111111111111000000000000100000000100000000000000000000001
1111111111111111000000000000100000000100000000000000000000001
1111111111111111000000000000100000000100000000000000000000001
1111111111111111000000000000100000000100000000000000000000001
1111111111111111000000000000100000000100000000000000000000001
1111111111111111000000000000100000000100000000000000000000001
1111111111111111000000000000100000000100000000000000000000001
1111111111111111110000111111100000000100000000000000000000001
1111111111111111000000000000100000000111111111000011111111111
1111111111111111000000000000100000000100000000000000000000001
1111111111111111000000000000000000000100000000000000000000001
1000000000000001000000000000000000000100000000000000000000001
1000000000000001000000000000000000000100000000000000000000001
1000000000000001000000000000000000000100000000000000000000001
1000000000000001000000000000100000000100000000000000000000001
1000000000000001000000000000100000000100000000000000000000001
1000000000000001110000111111100000000100000000000000000000001
1000000000000001000000000000000000000100000000000000000000001
1000000000000001000000000000000000000100000000000000000000001
1000000000000000000000000000000000000000000000000000000000001
1000000000000000000000000000000000000000000000000000000000001
1000000000000000000000000000000000000000000000000000000000001
1000000000000000000000000000000000000000000000000000000000001
1000000000000001000000000000000000000100000000000000000000001
1000000000000001000000000000000000000100000000000000000000001
1110000111111111110000111111111111111111111111111111111111111
1000000001111111000000000000000000000111111111111111111111111
1000000001111111000000000000000000000111111111111111111111111
1000000001111111000000000000000000000111111111111111111111111
1000000001111111000000000000000000000111111111111111111111111
1000000001111111000000000000000000000111111111111111111111111
1000000001111111000000000000000000000111111111111111111111111
1111111111111111000000000000000000000111111111111111111111111
1111111111111111000000000000000000000111111111111111111111111
1111111111111111000000000000000000000111111111111111111111111
1111111111111111000000000000000000000111111111111111111111111
1111111111111111000000000000000000000111111111111111111111111
1111111111111111000000000000000000000111111111111111111111111
1111111111111111000000000000000000000111111111111111111111111
1111111111111111000000000000000000000111111111111111111111111
1111111111111111000000000000000000000111111111111111111111111
1111111111111111000000000000000000000111111111111111111111111
1111111111111111111111111111111111111111111111111111111111111

